taille=8
M M M M M M M M
M J V M M M O-Red M
M V B M M M B-Red M
M V B P M V P V
M V B M M M V M
M V V M M M M M
M M M M M M M M
M M M M M M M M