taille=8
G G G G G B M O-Red
G B G G G G M B-Red
G G G G G G M V
G J G G G G M G
G G G G G G M G
G G G G G B M G
M P B V G G M G
G G G G B M V P
