taille=8
M M M M M M M M
M M V M M M M M
M M B V M M M M
M J B V B-Red O-Red M M
M M M V M M M M
M M M M M M M M
M M M M M M M M
M M M M M M M M