taille=8
M M M M O-Red M M M
M M P M B-Red M M M
J B V M V M M M
M V M M V M M M
M V V V P M M M
M M M M M M M M
M M M M M M M M
M M M M M M M M